%%%%%%%%%%
%_    _ %%
%%  _% __%
%. _ _   %
%%   % __%
%   % % %%
%_    _% %
%  _ %  _%
%  %%   _%
%%%%%%%%%%
Parameters
draw 40
discount 1
InitPosition
2,2
InitPredicates
