9 21 4
%%%%%%%%%%%%%%%%%%%%%
% ...     %         %
% %%% %%% % %%% %%% %
% ..%...     ...%   %
%%%.%.%.%%%%%.%.% %%%
%..   %   %   %     %
%.%%% %%%.% %%% %%% %
%       ..       ...%
%%%%%%%%%%%%%%%%%%%%%
7 10 0
3 8 1
3 9 4
3 10 2
3 11 1 
